//MAP CONVERTED BY dmm2tgm.py THIS HEADER COMMENT PREVENTS RECONVERSION, DO NOT REMOVE
"at" = (
/obj/effect/turf_decal/trimline/white/filled/warning{
	dir = 8
	},
/obj/effect/spawner/lootdrop/grille_or_trash,
/turf/open/floor/plating/ashplanet/rocky{
	layer = 1.98
	},
/area/city)
"cC" = (
/obj/effect/turf_decal/trimline/red/filled/warning{
	dir = 1
	},
/turf/open/floor/plating/ashplanet{
	name = "asphalt"
	},
/area/city)
"cH" = (
/obj/effect/turf_decal/trimline/blue/filled/line{
	dir = 1
	},
/turf/open/floor/plating/ashplanet/rocky{
	layer = 1.98
	},
/area/city)
"dA" = (
/obj/effect/turf_decal/siding{
	dir = 6
	},
/turf/open/floor/plating/ashplanet{
	name = "asphalt"
	},
/area/city)
"fk" = (
/obj/effect/turf_decal/trimline/white/filled/warning{
	dir = 4
	},
/turf/open/floor/plating/ashplanet/rocky{
	layer = 1.98
	},
/area/city)
"fn" = (
/turf/open/floor/plating/ashplanet{
	name = "asphalt";
	density = 1
	},
/area/city)
"fX" = (
/obj/effect/turf_decal/trimline/white/filled/line{
	dir = 4;
	pixel_x = -10
	},
/turf/open/floor/plating/ashplanet{
	name = "asphalt";
	density = 1
	},
/area/city)
"gI" = (
/obj/structure/chair/plastic{
	dir = 1
	},
/turf/open/floor/plating/ashplanet/rocky{
	layer = 1.98
	},
/area/city)
"gQ" = (
/obj/effect/turf_decal/trimline/red/filled/warning{
	dir = 9
	},
/turf/open/floor/plating/ashplanet{
	name = "asphalt"
	},
/area/city)
"gR" = (
/obj/effect/turf_decal/trimline/blue/filled/corner{
	dir = 4
	},
/turf/open/floor/plating/ashplanet/rocky{
	layer = 1.98
	},
/area/city)
"hk" = (
/obj/effect/turf_decal/trimline/red/filled/warning,
/obj/docking_port/stationary{
	dwidth = 5;
	height = 5;
	id = "insurgence_1";
	name = "insurgence 1";
	width = 10
	},
/turf/open/floor/plating/ashplanet{
	name = "asphalt"
	},
/area/city)
"iW" = (
/turf/open/floor/wood{
	density = 1
	},
/area/city)
"iZ" = (
/obj/effect/turf_decal/trimline/white/line{
	dir = 8
	},
/turf/open/floor/plating/ashplanet{
	name = "asphalt"
	},
/area/city)
"kg" = (
/turf/open/ai_visible{
	density = 1
	},
/area/city)
"kT" = (
/obj/effect/turf_decal/trimline/yellow/filled/line{
	dir = 8;
	pixel_x = 5
	},
/obj/effect/turf_decal/trimline/yellow/filled/line{
	dir = 4;
	pixel_x = -5
	},
/turf/open/floor/plating/ashplanet{
	name = "asphalt"
	},
/area/city)
"kX" = (
/obj/effect/turf_decal/siding{
	dir = 4
	},
/turf/open/floor/plating/ashplanet{
	name = "asphalt"
	},
/area/city)
"mv" = (
/obj/effect/turf_decal/trimline/white/filled/line{
	pixel_y = 10
	},
/turf/open/floor/plating/ashplanet{
	name = "asphalt"
	},
/area/city)
"mN" = (
/obj/effect/turf_decal/trimline/white/filled/line{
	pixel_y = 10
	},
/turf/open/floor/plating/ashplanet{
	name = "asphalt";
	density = 1
	},
/area/city)
"ni" = (
/obj/effect/spawner/lootdrop/grille_or_trash,
/turf/open/floor/plating/ashplanet/rocky{
	layer = 1.98
	},
/area/city)
"nq" = (
/obj/machinery/light/broken{
	dir = 8
	},
/obj/effect/decal/cleanable/dirt/dust,
/turf/open/floor/wood{
	density = 1
	},
/area/city)
"ok" = (
/obj/machinery/light/broken{
	dir = 8
	},
/turf/open/floor/wood{
	density = 1
	},
/area/city)
"pJ" = (
/obj/effect/turf_decal/trimline/blue/filled/line{
	dir = 4
	},
/turf/open/floor/plating/ashplanet/rocky{
	layer = 1.98
	},
/area/city)
"pR" = (
/obj/structure/chair/wood{
	dir = 4
	},
/turf/open/floor/wood{
	density = 1
	},
/area/city)
"qf" = (
/obj/machinery/light,
/turf/open/floor/plating/ashplanet/rocky{
	layer = 1.98
	},
/area/city)
"rn" = (
/obj/effect/turf_decal/trimline/red/filled/warning{
	dir = 8
	},
/turf/open/floor/plating/ashplanet{
	name = "asphalt"
	},
/area/city)
"rL" = (
/obj/structure/fluff/paper/stack{
	dir = 4
	},
/turf/open/floor/plating/ashplanet/rocky{
	layer = 1.98
	},
/area/city)
"sa" = (
/turf/open/floor/mineral/plastitanium,
/area/insurgence_truck)
"sh" = (
/turf/open/floor/carpet/royalblue{
	density = 1
	},
/area/city)
"sO" = (
/obj/effect/turf_decal/trimline/white/filled/warning{
	dir = 8
	},
/turf/open/floor/plating/ashplanet/rocky{
	layer = 1.98
	},
/area/city)
"tz" = (
/obj/machinery/door/airlock/survival_pod,
/turf/open/floor/mineral/plastitanium,
/area/insurgence_truck)
"us" = (
/obj/effect/turf_decal/trimline/red/filled/warning{
	dir = 6
	},
/turf/open/floor/plating/ashplanet{
	name = "asphalt"
	},
/area/city)
"uB" = (
/obj/structure/rack,
/turf/open/floor/mineral/plastitanium,
/area/insurgence_truck)
"vd" = (
/obj/structure/fluff/street_light,
/turf/open/floor/plating/ashplanet/rocky{
	layer = 1.98
	},
/area/city)
"vy" = (
/obj/structure/barricade/wooden/crude,
/turf/closed/indestructible/fakeglass,
/area/city)
"vA" = (
/obj/machinery/camera/all{
	dir = 4
	},
/turf/open/floor/plating/ashplanet/rocky{
	layer = 1.98
	},
/area/city)
"wA" = (
/obj/effect/turf_decal/trimline/yellow/filled/line{
	pixel_y = 5
	},
/obj/effect/turf_decal/trimline/yellow/filled/line{
	dir = 1;
	pixel_y = -5
	},
/turf/open/floor/plating/ashplanet{
	name = "asphalt"
	},
/area/city)
"yi" = (
/obj/structure/fluff/parking_sign,
/turf/open/floor/plating/ashplanet/rocky{
	layer = 1.98
	},
/area/city)
"zB" = (
/obj/effect/turf_decal/trimline/white/filled/warning{
	dir = 8
	},
/obj/effect/spawner/lootdrop/grille_or_trash,
/obj/structure/fluff/street_light,
/turf/open/floor/plating/ashplanet/rocky{
	layer = 1.98
	},
/area/city)
"zN" = (
/obj/effect/turf_decal/trimline/red/filled/warning{
	dir = 5
	},
/turf/open/floor/plating/ashplanet{
	name = "asphalt"
	},
/area/city)
"zR" = (
/obj/structure/window/shuttle/survival_pod,
/turf/open/floor/mineral/plastitanium,
/area/insurgence_truck)
"Ad" = (
/obj/effect/turf_decal/trimline/blue/filled/line{
	dir = 5
	},
/turf/open/floor/plating/ashplanet/rocky{
	layer = 1.98
	},
/area/city)
"AV" = (
/obj/effect/turf_decal/trimline/white/filled/warning{
	dir = 8
	},
/obj/structure/fluff/street_light,
/turf/open/floor/plating/ashplanet/rocky{
	layer = 1.98
	},
/area/city)
"BD" = (
/obj/structure/chair/comfy/shuttle{
	dir = 4
	},
/turf/open/floor/mineral/plastitanium,
/area/insurgence_truck)
"Ce" = (
/obj/effect/turf_decal/siding,
/turf/open/floor/plating/ashplanet{
	name = "asphalt"
	},
/area/city)
"Er" = (
/obj/effect/turf_decal/trimline/yellow/filled/line{
	dir = 8;
	pixel_x = 5
	},
/obj/effect/turf_decal/trimline/yellow/filled/line{
	dir = 4;
	pixel_x = -5
	},
/turf/open/floor/plating/ashplanet{
	name = "asphalt";
	density = 1
	},
/area/city)
"EI" = (
/obj/effect/turf_decal/trimline/white/line{
	dir = 4
	},
/turf/open/floor/plating/ashplanet{
	name = "asphalt"
	},
/area/city)
"Fu" = (
/obj/effect/turf_decal/trimline/white/filled/warning{
	dir = 4
	},
/obj/effect/spawner/lootdrop/grille_or_trash,
/turf/open/floor/plating/ashplanet/rocky{
	layer = 1.98
	},
/area/city)
"FC" = (
/obj/machinery/door/poddoor/shutters,
/turf/open/floor/mineral/plastitanium,
/area/insurgence_truck)
"Gc" = (
/obj/effect/turf_decal/trimline/red/filled/warning{
	dir = 10
	},
/turf/open/floor/plating/ashplanet{
	name = "asphalt"
	},
/area/city)
"Gs" = (
/obj/effect/turf_decal/trimline/red/filled/warning{
	dir = 4
	},
/turf/open/floor/plating/ashplanet{
	name = "asphalt"
	},
/area/city)
"GF" = (
/obj/machinery/door/keycard/library{
	puzzle_id = "home"
	},
/turf/open/floor/wood{
	density = 1
	},
/area/city)
"HT" = (
/turf/closed/indestructible/reinforced,
/area/city)
"Jb" = (
/obj/effect/turf_decal/trimline/white/filled/line{
	dir = 4;
	pixel_x = -10
	},
/turf/open/floor/plating/ashplanet{
	name = "asphalt"
	},
/area/city)
"Jy" = (
/turf/closed/indestructible/rock,
/area/space)
"Km" = (
/obj/effect/turf_decal/trimline/white/filled/warning{
	dir = 8
	},
/obj/structure/tank_holder/extinguisher,
/turf/open/floor/plating/ashplanet/rocky{
	layer = 1.98
	},
/area/city)
"La" = (
/turf/closed/indestructible/fakedoor,
/area/city)
"LH" = (
/obj/structure/closet/crate/large,
/turf/open/floor/mineral/plastitanium,
/area/insurgence_truck)
"Mq" = (
/obj/structure/fluff/paper/stack{
	dir = 8
	},
/obj/structure/tank_holder/extinguisher,
/turf/open/floor/plating/ashplanet/rocky{
	layer = 1.98
	},
/area/city)
"ME" = (
/obj/machinery/computer/shuttle/mining{
	dir = 1;
	name = "bus console";
	possible_destinations = "insurgence_1";
	shuttleId = "quest";
	resistance_flags = 64
	},
/turf/open/floor/plating/ashplanet/rocky{
	layer = 1.98
	},
/area/city)
"Op" = (
/obj/structure/fluff/paper/stack{
	dir = 4
	},
/obj/structure/fluff/street_light,
/turf/open/floor/plating/ashplanet/rocky{
	layer = 1.98
	},
/area/city)
"ON" = (
/obj/effect/turf_decal/trimline/yellow/filled/line{
	dir = 10
	},
/turf/open/floor/plating/ashplanet{
	name = "asphalt";
	density = 1
	},
/area/city)
"QU" = (
/obj/structure/table/wood,
/turf/open/floor/wood{
	density = 1
	},
/area/city)
"Rr" = (
/obj/effect/turf_decal/siding{
	dir = 1
	},
/turf/open/floor/plating/ashplanet{
	name = "asphalt"
	},
/area/city)
"RS" = (
/obj/machinery/modular_computer/console/preset/civilian{
	dir = 8
	},
/turf/open/floor/mineral/plastitanium,
/area/insurgence_truck)
"SZ" = (
/obj/effect/turf_decal/trimline/yellow/filled/line{
	pixel_y = 5
	},
/obj/effect/turf_decal/trimline/yellow/filled/line{
	dir = 1;
	pixel_y = -5
	},
/turf/open/floor/plating/ashplanet{
	name = "asphalt";
	density = 1
	},
/area/city)
"Ub" = (
/obj/effect/turf_decal/trimline/red/filled/warning,
/turf/open/floor/plating/ashplanet{
	name = "asphalt"
	},
/area/city)
"UN" = (
/turf/open/floor/plating/ashplanet{
	name = "asphalt"
	},
/area/city)
"Vm" = (
/turf/closed/indestructible/wood,
/area/city)
"Vw" = (
/obj/effect/decal/cleanable/dirt/dust,
/turf/open/floor/wood{
	density = 1
	},
/area/city)
"VZ" = (
/obj/effect/turf_decal/trimline/white/filled/warning{
	dir = 4
	},
/obj/structure/fluff/street_light,
/turf/open/floor/plating/ashplanet/rocky{
	layer = 1.98
	},
/area/city)
"Wf" = (
/turf/closed/indestructible/syndicate,
/area/insurgence_truck)
"WL" = (
/obj/structure/fluff/paper/stack{
	dir = 8
	},
/turf/open/floor/plating/ashplanet/rocky{
	layer = 1.98
	},
/area/city)
"WR" = (
/obj/effect/turf_decal/siding{
	dir = 5
	},
/turf/open/floor/plating/ashplanet{
	name = "asphalt"
	},
/area/city)
"WX" = (
/obj/machinery/requests_console{
	pixel_y = 32
	},
/obj/structure/chair/comfy/shuttle{
	dir = 4
	},
/turf/open/floor/mineral/plastitanium,
/area/insurgence_truck)
"Zh" = (
/turf/open/floor/plating/ashplanet/rocky{
	layer = 1.98
	},
/area/city)

(1,1,1) = {"
Jy
Jy
Jy
Jy
Jy
Jy
Jy
Jy
Jy
Jy
Jy
Jy
Jy
Jy
Jy
Jy
Jy
Jy
Jy
Jy
Jy
Jy
Jy
Jy
Jy
Jy
Jy
Jy
Jy
Jy
Jy
Jy
Jy
Jy
Jy
Jy
Jy
Jy
Jy
Jy
Jy
Jy
Jy
Jy
Jy
Jy
Jy
Jy
Jy
Jy
Jy
Jy
Jy
Jy
Jy
Jy
Jy
Jy
Jy
Jy
Jy
Jy
Jy
Jy
Jy
Jy
Jy
Jy
Jy
Jy
"}
(2,1,1) = {"
Jy
Jy
Jy
Jy
Jy
Jy
Jy
Jy
Jy
Jy
Jy
Jy
Jy
Jy
Jy
Jy
Jy
Jy
Jy
Jy
Jy
Jy
Jy
Jy
Jy
Jy
Jy
Jy
Jy
Jy
Jy
Jy
Jy
Jy
Jy
Jy
Jy
Jy
Jy
Jy
Jy
Jy
Jy
Jy
Jy
Jy
Jy
Jy
Jy
Jy
Jy
Jy
Jy
Jy
Jy
Jy
Jy
Jy
Jy
Jy
Jy
Jy
Jy
Jy
Jy
Jy
Jy
Jy
Jy
Jy
"}
(3,1,1) = {"
Jy
Jy
Jy
Jy
Jy
Jy
Jy
Jy
Jy
Jy
Jy
Jy
Jy
Jy
Jy
Jy
Jy
Jy
Jy
Jy
Jy
Jy
Jy
Jy
Jy
Jy
Jy
Jy
Jy
Jy
Jy
Jy
Jy
Jy
Jy
Jy
Jy
Jy
Jy
Jy
Jy
Jy
Jy
Jy
Jy
Jy
Jy
Jy
Jy
Jy
Jy
Jy
Jy
Jy
Jy
Jy
Jy
Jy
Jy
Jy
Jy
Jy
Jy
Jy
Jy
Jy
Jy
Jy
Jy
Jy
"}
(4,1,1) = {"
Jy
Jy
Jy
Jy
Jy
Jy
Jy
Jy
Jy
Jy
Jy
Jy
Jy
Jy
Jy
Jy
Jy
Jy
Jy
Jy
Jy
Jy
Jy
Jy
Jy
Jy
Jy
Jy
Jy
Jy
Jy
Jy
Jy
Jy
Jy
Jy
Jy
Jy
Jy
Jy
Jy
Jy
Jy
Jy
Jy
Jy
Jy
Jy
Jy
Jy
Jy
Jy
Jy
Jy
Jy
Jy
Jy
Jy
Jy
Jy
Jy
Jy
Jy
Jy
Jy
Jy
Jy
Jy
Jy
Jy
"}
(5,1,1) = {"
Jy
Jy
Jy
Jy
Jy
Jy
Jy
Jy
Jy
Jy
Jy
Jy
Jy
Jy
Jy
Jy
Jy
Jy
Jy
Jy
Jy
Jy
Jy
Vm
Vm
Vm
Vm
Vm
Vm
Jy
Jy
Jy
Jy
Jy
Jy
Jy
Jy
Jy
Jy
Jy
Jy
Vm
Vm
Vm
Vm
Vm
Vm
Jy
Jy
Jy
Jy
Jy
Jy
Jy
Jy
Jy
Jy
Jy
Jy
Jy
Jy
Jy
Jy
Jy
Jy
Jy
Jy
Jy
Jy
Jy
"}
(6,1,1) = {"
Jy
Jy
Jy
Jy
Jy
Jy
Jy
Jy
Jy
Jy
Jy
Jy
Jy
Jy
Jy
Jy
Jy
Jy
Jy
Jy
Jy
Jy
Jy
Vm
nq
pR
iW
ok
Vm
Jy
Jy
Jy
Jy
Jy
Jy
Jy
Jy
Jy
Jy
Jy
Jy
Vm
nq
iW
iW
ok
Vm
Jy
Jy
Jy
Jy
Jy
Jy
Jy
Jy
Jy
Jy
Jy
Jy
Jy
Jy
Jy
Jy
Jy
Jy
Jy
Jy
Jy
Jy
Jy
"}
(7,1,1) = {"
Jy
Jy
Jy
Jy
Jy
Jy
Jy
Jy
Jy
Jy
Jy
Jy
Jy
Jy
Jy
Jy
Jy
Jy
Jy
Jy
Jy
Jy
Jy
Vm
QU
QU
QU
iW
Vm
Jy
Jy
Jy
Jy
Jy
Jy
Jy
Jy
Jy
Jy
Jy
Jy
Vm
iW
sh
sh
iW
Vm
Jy
Jy
Jy
Jy
Jy
Jy
Jy
Jy
Jy
Jy
Jy
Jy
Jy
Jy
Jy
Jy
Jy
Jy
Jy
Jy
Jy
Jy
Jy
"}
(8,1,1) = {"
Jy
Jy
Jy
Jy
Jy
Jy
Jy
Jy
Jy
Jy
Jy
Jy
Jy
Jy
Jy
Jy
Jy
Jy
Jy
Jy
Jy
Jy
Jy
Vm
Vw
iW
Vw
Vw
Vm
Jy
Jy
Jy
Jy
Jy
Jy
Jy
Jy
Jy
Jy
Jy
Jy
Vm
iW
sh
sh
iW
Vm
Jy
Jy
Jy
Jy
Jy
Jy
Jy
Jy
Jy
Jy
Jy
Jy
Jy
Jy
Jy
Jy
Jy
Jy
Jy
Jy
Jy
Jy
Jy
"}
(9,1,1) = {"
Jy
Jy
Jy
Jy
Jy
Jy
Jy
Jy
Jy
Jy
Jy
Jy
Jy
Jy
Jy
Jy
Jy
Jy
Jy
Jy
Jy
Jy
Jy
GF
iW
iW
Vw
iW
Vm
Jy
Jy
Jy
Jy
Jy
Jy
Jy
Jy
Jy
Jy
Jy
Jy
GF
iW
iW
Vw
iW
Vm
Jy
Jy
Jy
Jy
Jy
Jy
Jy
Jy
Jy
Jy
Jy
Jy
Jy
Jy
Jy
Jy
Jy
Jy
Jy
Jy
Jy
Jy
Jy
"}
(10,1,1) = {"
Jy
Jy
Jy
Jy
Jy
Jy
Jy
Jy
Jy
Jy
Jy
Jy
Jy
Jy
Jy
Jy
Jy
HT
HT
La
HT
HT
HT
HT
HT
vy
vy
La
HT
HT
HT
HT
HT
HT
HT
HT
La
HT
HT
HT
HT
HT
HT
vy
vy
La
HT
HT
HT
HT
HT
HT
HT
HT
HT
HT
La
HT
Jy
Jy
Jy
Jy
Jy
Jy
Jy
Jy
Jy
Jy
Jy
Jy
"}
(11,1,1) = {"
Jy
Jy
Jy
Jy
Jy
Jy
Jy
Jy
Jy
Jy
Jy
Jy
Jy
Jy
Jy
Jy
Jy
HT
WL
Zh
Zh
Zh
Zh
Zh
vA
Zh
Zh
Zh
Zh
ni
Zh
Zh
Zh
Zh
Zh
Zh
Zh
Zh
ni
Zh
Zh
Zh
vA
Zh
Zh
Zh
Zh
Zh
Zh
ni
Zh
Zh
Mq
Zh
Zh
Zh
Zh
HT
Jy
Jy
Jy
Jy
Jy
Jy
Jy
Jy
Jy
Jy
Jy
Jy
"}
(12,1,1) = {"
HT
HT
HT
HT
HT
HT
HT
HT
HT
HT
HT
HT
HT
HT
HT
HT
HT
HT
VZ
fk
fk
fk
fk
fk
fk
VZ
Fu
fk
fk
fk
fk
fk
VZ
fk
fk
fk
fk
fk
fk
fk
fk
fk
VZ
fk
fk
fk
fk
fk
VZ
fk
fk
fk
fk
fk
fk
fk
VZ
HT
HT
HT
HT
HT
HT
HT
HT
HT
HT
HT
HT
HT
"}
(13,1,1) = {"
kg
fn
fn
fX
fn
fn
fn
fX
fn
fn
fn
fX
fn
fn
fn
fX
fn
UN
iZ
iZ
iZ
iZ
iZ
iZ
iZ
iZ
iZ
iZ
iZ
iZ
iZ
iZ
iZ
iZ
iZ
iZ
iZ
iZ
iZ
iZ
iZ
iZ
iZ
iZ
iZ
iZ
iZ
iZ
iZ
iZ
iZ
iZ
iZ
iZ
iZ
iZ
iZ
fn
fn
fX
fn
fn
fn
fX
fn
fn
fn
fX
fn
kg
"}
(14,1,1) = {"
kg
fn
fn
fn
fn
fn
fn
fn
fn
fn
fn
fn
fn
fn
fn
fn
fn
UN
UN
UN
UN
UN
UN
UN
UN
UN
UN
UN
UN
UN
UN
UN
UN
UN
UN
UN
UN
UN
UN
UN
UN
UN
UN
Jb
Jb
Jb
Jb
Jb
UN
UN
UN
UN
UN
UN
UN
UN
UN
fn
fn
fn
fn
fn
fn
fn
fn
fn
fn
fn
fn
kg
"}
(15,1,1) = {"
kg
fX
fn
fn
fn
fX
fn
fn
fn
fX
fn
fn
fn
fX
fn
fn
fn
Jb
UN
UN
UN
Jb
UN
UN
UN
Jb
UN
UN
UN
Jb
UN
UN
UN
Jb
UN
UN
UN
Jb
UN
UN
UN
Jb
UN
Jb
Jb
Jb
Jb
Jb
UN
Jb
UN
UN
UN
Jb
UN
UN
UN
fX
fn
fn
fn
fX
fn
fn
fn
fX
fn
fn
fn
kg
"}
(16,1,1) = {"
kg
Er
Er
Er
Er
Er
Er
Er
Er
Er
Er
Er
Er
Er
Er
Er
Er
kT
kT
kT
kT
kT
kT
kT
kT
kT
kT
kT
kT
kT
kT
kT
kT
kT
kT
kT
kT
kT
kT
kT
kT
kT
kT
Jb
Jb
Jb
Jb
Jb
kT
kT
kT
kT
kT
kT
kT
kT
kT
Er
Er
Er
Er
Er
Er
Er
Er
Er
Er
Er
Er
kg
"}
(17,1,1) = {"
kg
fX
fn
fn
fn
fX
fn
fn
fn
fX
fn
fn
fn
fX
fn
fn
fn
Jb
UN
UN
UN
Jb
UN
UN
UN
Jb
UN
UN
UN
Jb
UN
UN
UN
Jb
UN
UN
UN
Jb
UN
UN
UN
Jb
UN
Jb
Jb
Jb
Jb
Jb
UN
Jb
UN
UN
UN
Jb
UN
UN
UN
fX
fn
fn
fn
fX
fn
fn
fn
fX
fn
fn
fn
kg
"}
(18,1,1) = {"
kg
fn
fn
fn
fn
fn
fn
fn
fn
fn
fn
fn
fn
fn
fn
fn
fn
UN
UN
UN
UN
UN
UN
UN
UN
UN
UN
UN
UN
UN
UN
UN
UN
UN
UN
UN
UN
UN
UN
UN
UN
UN
UN
Jb
Jb
Jb
Jb
Jb
UN
UN
UN
UN
UN
UN
UN
UN
UN
fn
fn
fn
fn
fn
fn
fn
fn
fn
fn
fn
fn
kg
"}
(19,1,1) = {"
kg
fn
fn
fX
fn
fn
fn
fX
fn
fn
fn
fX
fn
fn
fn
fX
fn
UN
EI
EI
EI
EI
EI
EI
EI
EI
EI
EI
EI
EI
EI
EI
EI
EI
EI
EI
EI
EI
EI
EI
EI
EI
EI
EI
EI
EI
EI
EI
EI
EI
EI
EI
EI
EI
EI
EI
EI
fn
fn
fX
fn
fn
fn
fX
fn
fn
fn
fX
fn
kg
"}
(20,1,1) = {"
HT
HT
HT
HT
HT
HT
HT
HT
HT
HT
HT
HT
HT
HT
HT
HT
HT
HT
sO
sO
Km
Rr
UN
UN
UN
UN
UN
UN
UN
UN
UN
Ce
AV
sO
at
sO
sO
sO
sO
sO
sO
sO
AV
sO
sO
sO
sO
sO
AV
sO
sO
sO
sO
sO
sO
sO
zB
HT
HT
HT
HT
HT
HT
HT
HT
HT
HT
HT
HT
HT
"}
(21,1,1) = {"
Jy
Jy
Jy
Jy
Jy
Jy
Jy
Jy
Jy
Jy
Jy
Jy
Jy
Jy
Jy
Jy
Jy
HT
Zh
Zh
Zh
Rr
UN
UN
UN
UN
UN
UN
UN
UN
UN
Ce
yi
Zh
Zh
Zh
Zh
Zh
Zh
Zh
Zh
Zh
Zh
Zh
Zh
Zh
Zh
Zh
Zh
Zh
Zh
Zh
Zh
Zh
Zh
Zh
Zh
HT
Jy
Jy
Jy
Jy
Jy
Jy
Jy
Jy
Jy
Jy
Jy
Jy
"}
(22,1,1) = {"
Jy
Jy
Jy
Jy
Jy
Jy
Jy
Jy
Jy
Jy
Jy
Jy
Jy
Jy
Jy
Jy
Jy
HT
ni
Zh
Zh
Rr
Wf
FC
FC
FC
Wf
UN
UN
UN
UN
Ce
Zh
Zh
HT
HT
HT
HT
HT
vy
vy
La
HT
HT
HT
HT
HT
HT
HT
Zh
Zh
Zh
Zh
Zh
Zh
Zh
Zh
HT
Jy
Jy
Jy
Jy
Jy
Jy
Jy
Jy
Jy
Jy
Jy
Jy
"}
(23,1,1) = {"
Jy
Jy
Jy
Jy
Jy
Jy
Jy
Jy
Jy
Jy
Jy
Jy
Jy
Jy
Jy
Jy
Jy
HT
Op
Zh
Zh
Rr
Wf
sa
sa
sa
Wf
UN
UN
UN
UN
Ce
Zh
rL
HT
Jy
Jy
Vm
nq
iW
ok
iW
Vm
Jy
Jy
Jy
Jy
Jy
HT
pJ
pJ
pJ
pJ
pJ
gR
Zh
HT
HT
Jy
Jy
Jy
Jy
Jy
Jy
Jy
Jy
Jy
Jy
Jy
Jy
"}
(24,1,1) = {"
Jy
Jy
Jy
Jy
Jy
Jy
Jy
Jy
Jy
Jy
Jy
Jy
Jy
Jy
Jy
Jy
Jy
HT
HT
HT
Zh
Rr
Wf
LH
sa
LH
Wf
UN
UN
UN
UN
Ce
Zh
Zh
HT
Jy
Jy
Vm
iW
iW
iW
iW
Vm
Jy
Jy
Jy
Jy
Jy
HT
gQ
UN
rn
wA
Gc
cH
Zh
HT
Jy
Jy
Jy
Jy
Jy
Jy
Jy
Jy
Jy
Jy
Jy
Jy
Jy
"}
(25,1,1) = {"
Jy
Jy
Jy
Jy
Jy
Jy
Jy
Jy
Jy
Jy
Jy
Jy
Jy
Jy
Jy
Jy
Jy
Jy
Jy
HT
Zh
Rr
Wf
LH
sa
LH
Wf
UN
UN
UN
UN
Ce
Zh
Zh
HT
Jy
Jy
Vm
iW
pR
pR
iW
Vm
Jy
Jy
Jy
Jy
Jy
HT
UN
UN
UN
wA
UN
cH
qf
HT
Jy
Jy
Jy
Jy
Jy
Jy
Jy
Jy
Jy
Jy
Jy
Jy
Jy
"}
(26,1,1) = {"
Jy
Jy
Jy
Jy
Jy
Jy
Jy
Jy
Jy
Jy
Jy
Jy
Jy
Jy
Jy
Jy
Jy
Jy
Jy
HT
Zh
Rr
Wf
uB
sa
uB
Wf
UN
UN
UN
UN
Ce
Zh
Zh
HT
Jy
Jy
GF
iW
QU
QU
iW
Vm
Jy
Jy
Jy
Jy
Jy
HT
cC
UN
mv
wA
Ub
cH
gI
HT
Jy
Jy
Jy
Jy
Jy
Jy
Jy
Jy
Jy
Jy
Jy
Jy
Jy
"}
(27,1,1) = {"
Jy
Jy
Jy
Jy
Jy
Jy
Jy
Jy
Jy
Jy
Jy
Jy
Jy
Jy
Jy
Jy
Jy
Jy
Jy
HT
Zh
Rr
Wf
uB
sa
uB
Wf
UN
UN
UN
UN
Ce
Zh
Zh
HT
Jy
Jy
Vm
Vm
Vm
Vm
Vm
Vm
Jy
Jy
Jy
Jy
Jy
HT
UN
UN
UN
wA
UN
cH
gI
HT
Jy
Jy
Jy
Jy
Jy
Jy
Jy
Jy
Jy
Jy
Jy
Jy
Jy
"}
(28,1,1) = {"
Jy
Jy
Jy
Jy
Jy
Jy
Jy
Jy
Jy
Jy
Jy
Jy
Jy
Jy
Jy
Jy
Jy
Jy
Jy
La
Zh
Rr
Wf
Wf
FC
Wf
Wf
UN
UN
UN
UN
Ce
ni
Zh
HT
Jy
Jy
Jy
Jy
Jy
Jy
Jy
Jy
Jy
Jy
Jy
Jy
Jy
HT
cC
UN
UN
wA
hk
cH
Zh
HT
Jy
Jy
Jy
Jy
Jy
Jy
Jy
Jy
Jy
Jy
Jy
Jy
Jy
"}
(29,1,1) = {"
Jy
Jy
Jy
Jy
Jy
Jy
Jy
Jy
Jy
Jy
Jy
Jy
Jy
Jy
Jy
Jy
Jy
Jy
Jy
HT
Zh
Rr
Wf
WX
sa
BD
tz
UN
UN
UN
UN
Ce
Zh
Zh
HT
Jy
Jy
Jy
Jy
Jy
Jy
Jy
Jy
Jy
Jy
Jy
Jy
Jy
HT
UN
mv
UN
wA
UN
cH
gI
HT
Jy
Jy
Jy
Jy
Jy
Jy
Jy
Jy
Jy
Jy
Jy
Jy
Jy
"}
(30,1,1) = {"
Jy
Jy
Jy
Jy
Jy
Jy
Jy
Jy
Jy
Jy
Jy
Jy
Jy
Jy
Jy
Jy
Jy
Jy
Jy
HT
Zh
Rr
Wf
RS
sa
RS
Wf
UN
UN
UN
UN
Ce
Zh
Zh
HT
Jy
Jy
Jy
Jy
Jy
Jy
Jy
Jy
Jy
Jy
Jy
Jy
Jy
HT
cC
UN
UN
wA
Ub
cH
gI
HT
Jy
Jy
Jy
Jy
Jy
Jy
Jy
Jy
Jy
Jy
Jy
Jy
Jy
"}
(31,1,1) = {"
Jy
Jy
Jy
Jy
Jy
Jy
Jy
Jy
Jy
Jy
Jy
Jy
Jy
Jy
Jy
Jy
Jy
Jy
Jy
HT
Zh
Rr
Wf
zR
zR
zR
Wf
UN
UN
UN
UN
Ce
Zh
Zh
La
Jy
Jy
Jy
Jy
Jy
Jy
Jy
Jy
Jy
Jy
Jy
Jy
Jy
HT
UN
UN
UN
wA
UN
cH
qf
HT
HT
Jy
Jy
Jy
Jy
Jy
Jy
Jy
Jy
Jy
Jy
Jy
Jy
"}
(32,1,1) = {"
Jy
Jy
Jy
Jy
Jy
Jy
Jy
Jy
Jy
Jy
Jy
Jy
Jy
Jy
Jy
Jy
Jy
Jy
Jy
HT
Zh
WR
kX
kX
kX
kX
kX
kX
kX
kX
kX
dA
Zh
Zh
HT
Jy
Jy
Jy
Jy
Jy
Jy
Jy
Jy
Jy
Jy
Jy
Jy
Jy
HT
zN
UN
Gs
wA
us
Ad
gR
ME
HT
Jy
Jy
Jy
Jy
Jy
Jy
Jy
Jy
Jy
Jy
Jy
Jy
"}
(33,1,1) = {"
Jy
Jy
Jy
Jy
Jy
Jy
Jy
Jy
Jy
Jy
Jy
Jy
Jy
Jy
Jy
Jy
Jy
Jy
Jy
HT
ni
Zh
Zh
Zh
Zh
Zh
Zh
Zh
Zh
Zh
Zh
Zh
Zh
Zh
HT
Jy
Jy
Jy
Jy
Jy
Jy
Jy
Jy
Jy
Jy
Jy
Jy
Jy
HT
fn
fn
fn
SZ
fn
fn
Ad
HT
HT
Jy
Jy
Jy
Jy
Jy
Jy
Jy
Jy
Jy
Jy
Jy
Jy
"}
(34,1,1) = {"
Jy
Jy
Jy
Jy
Jy
Jy
Jy
Jy
Jy
Jy
Jy
Jy
Jy
Jy
Jy
Jy
Jy
Jy
Jy
HT
vd
Zh
Zh
Zh
Zh
Zh
Zh
Zh
rL
Zh
ni
Zh
Zh
vd
HT
Jy
Jy
Jy
Jy
Jy
Jy
Jy
Jy
Jy
Jy
Jy
Jy
Jy
HT
fn
fn
fn
SZ
fn
fn
fn
HT
Jy
Jy
Jy
Jy
Jy
Jy
Jy
Jy
Jy
Jy
Jy
Jy
Jy
"}
(35,1,1) = {"
Jy
Jy
Jy
Jy
Jy
Jy
Jy
Jy
Jy
Jy
Jy
Jy
Jy
Jy
Jy
Jy
Jy
Jy
Jy
HT
HT
HT
HT
HT
HT
La
HT
HT
HT
HT
HT
HT
HT
HT
HT
Jy
Jy
Jy
Jy
Jy
Jy
Jy
Jy
Jy
Jy
Jy
Jy
Jy
HT
fn
mN
fn
SZ
fn
mN
fn
HT
Jy
Jy
Jy
Jy
Jy
Jy
Jy
Jy
Jy
Jy
Jy
Jy
Jy
"}
(36,1,1) = {"
Jy
Jy
Jy
Jy
Jy
Jy
Jy
Jy
Jy
Jy
Jy
Jy
Jy
Jy
Jy
Jy
Jy
Jy
Jy
Jy
Jy
Jy
Jy
Jy
Jy
Jy
Jy
Jy
Jy
Jy
Jy
Jy
Jy
Jy
Jy
Jy
Jy
Jy
Jy
Jy
Jy
Jy
Jy
Jy
Jy
Jy
Jy
Jy
HT
fn
fn
fn
SZ
fn
fn
fn
HT
Jy
Jy
Jy
Jy
Jy
Jy
Jy
Jy
Jy
Jy
Jy
Jy
Jy
"}
(37,1,1) = {"
Jy
Jy
Jy
Jy
Jy
Jy
Jy
Jy
Jy
Jy
Jy
Jy
Jy
Jy
Jy
Jy
Jy
Jy
Jy
Jy
Jy
Jy
Jy
Jy
Jy
Jy
Jy
Jy
Jy
Jy
Jy
Jy
Jy
Jy
Jy
Jy
Jy
Jy
Jy
Jy
Jy
Jy
Jy
Jy
Jy
Jy
Jy
Jy
HT
fn
fn
fn
SZ
fn
fn
fn
HT
Jy
Jy
Jy
Jy
Jy
Jy
Jy
Jy
Jy
Jy
Jy
Jy
Jy
"}
(38,1,1) = {"
Jy
Jy
Jy
Jy
Jy
Jy
Jy
Jy
Jy
Jy
Jy
Jy
Jy
Jy
Jy
Jy
Jy
Jy
Jy
Jy
Jy
Jy
Jy
Jy
Jy
Jy
Jy
Jy
Jy
Jy
Jy
Jy
Jy
Jy
Jy
Jy
Jy
Jy
Jy
Jy
Jy
Jy
Jy
Jy
Jy
Jy
Jy
Jy
HT
fn
fn
mN
SZ
mN
fn
fn
HT
Jy
Jy
Jy
Jy
Jy
Jy
Jy
Jy
Jy
Jy
Jy
Jy
Jy
"}
(39,1,1) = {"
Jy
Jy
Jy
Jy
Jy
Jy
Jy
Jy
Jy
Jy
Jy
Jy
Jy
Jy
Jy
Jy
Jy
Jy
Jy
Jy
Jy
Jy
Jy
Jy
Jy
Jy
Jy
Jy
Jy
Jy
Jy
Jy
Jy
Jy
Jy
Jy
Jy
Jy
Jy
Jy
Jy
Jy
Jy
Jy
Jy
Jy
Jy
Jy
HT
fn
fn
fn
SZ
fn
fn
fn
HT
Jy
Jy
Jy
Jy
Jy
Jy
Jy
Jy
Jy
Jy
Jy
Jy
Jy
"}
(40,1,1) = {"
Jy
Jy
Jy
Jy
Jy
Jy
Jy
Jy
Jy
Jy
Jy
Jy
Jy
Jy
Jy
Jy
Jy
Jy
Jy
Jy
Jy
Jy
Jy
Jy
Jy
Jy
Jy
Jy
Jy
Jy
Jy
Jy
Jy
Jy
Jy
Jy
Jy
Jy
Jy
Jy
Jy
Jy
Jy
Jy
Jy
Jy
Jy
Jy
HT
fn
fn
fn
SZ
fn
fn
fn
HT
Jy
Jy
Jy
Jy
Jy
Jy
Jy
Jy
Jy
Jy
Jy
Jy
Jy
"}
(41,1,1) = {"
Jy
Jy
Jy
Jy
Jy
Jy
Jy
Jy
Jy
Jy
Jy
Jy
Jy
Jy
Jy
Jy
Jy
Jy
Jy
Jy
Jy
Jy
Jy
Jy
Jy
Jy
Jy
Jy
Jy
Jy
Jy
Jy
Jy
Jy
Jy
Jy
Jy
Jy
Jy
Jy
Jy
Jy
Jy
Jy
Jy
Jy
Jy
Jy
HT
fn
mN
fn
SZ
fn
mN
fn
HT
HT
Jy
Jy
Jy
Jy
Jy
Jy
Jy
Jy
Jy
Jy
Jy
Jy
"}
(42,1,1) = {"
Jy
Jy
Jy
Jy
Jy
Jy
Jy
Jy
Jy
Jy
Jy
Jy
Jy
Jy
Jy
Jy
Jy
Jy
Jy
Jy
Jy
Jy
Jy
Jy
Jy
Jy
Jy
Jy
Jy
Jy
Jy
Jy
Jy
Jy
Jy
Jy
Jy
Jy
Jy
Jy
Jy
Jy
Jy
Jy
Jy
Jy
Jy
Jy
HT
fn
fn
fn
SZ
fn
fn
fn
fn
HT
HT
HT
HT
HT
HT
HT
HT
HT
Jy
Jy
Jy
Jy
"}
(43,1,1) = {"
Jy
Jy
Jy
Jy
Jy
Jy
Jy
Jy
Jy
Jy
Jy
Jy
Jy
Jy
Jy
Jy
Jy
Jy
Jy
Jy
Jy
Jy
Jy
Jy
Jy
Jy
Jy
Jy
Jy
Jy
Jy
Jy
Jy
Jy
Jy
Jy
Jy
Jy
Jy
Jy
Jy
Jy
Jy
Jy
Jy
Jy
Jy
Jy
HT
fn
fn
fn
SZ
fn
fn
fn
fn
fX
fn
fn
fn
fX
fn
fn
fn
fX
Jy
Jy
Jy
Jy
"}
(44,1,1) = {"
Jy
Jy
Jy
Jy
Jy
Jy
Jy
Jy
Jy
Jy
Jy
Jy
Jy
Jy
Jy
Jy
Jy
Jy
Jy
Jy
Jy
Jy
Jy
Jy
Jy
Jy
Jy
Jy
Jy
Jy
Jy
Jy
Jy
Jy
Jy
Jy
Jy
Jy
Jy
Jy
Jy
Jy
Jy
Jy
Jy
Jy
Jy
Jy
HT
fn
fn
mN
SZ
mN
fn
fn
fn
fn
fn
fn
fn
fn
fn
fn
fn
fn
Jy
Jy
Jy
Jy
"}
(45,1,1) = {"
Jy
Jy
Jy
Jy
Jy
Jy
Jy
Jy
Jy
Jy
Jy
Jy
Jy
Jy
Jy
Jy
Jy
Jy
Jy
Jy
Jy
Jy
Jy
Jy
Jy
Jy
Jy
Jy
Jy
Jy
Jy
Jy
Jy
Jy
Jy
Jy
Jy
Jy
Jy
Jy
Jy
Jy
Jy
Jy
Jy
Jy
Jy
Jy
HT
fn
fn
fn
SZ
fn
fn
fX
fn
fn
fn
fX
fn
fn
fn
fX
fn
fn
Jy
Jy
Jy
Jy
"}
(46,1,1) = {"
Jy
Jy
Jy
Jy
Jy
Jy
Jy
Jy
Jy
Jy
Jy
Jy
Jy
Jy
Jy
Jy
Jy
Jy
Jy
Jy
Jy
Jy
Jy
Jy
Jy
Jy
Jy
Jy
Jy
Jy
Jy
Jy
Jy
Jy
Jy
Jy
Jy
Jy
Jy
Jy
Jy
Jy
Jy
Jy
Jy
Jy
Jy
Jy
HT
fn
fn
fn
ON
Er
Er
Er
Er
Er
Er
Er
Er
Er
Er
Er
Er
Er
Jy
Jy
Jy
Jy
"}
(47,1,1) = {"
Jy
Jy
Jy
Jy
Jy
Jy
Jy
Jy
Jy
Jy
Jy
Jy
Jy
Jy
Jy
Jy
Jy
Jy
Jy
Jy
Jy
Jy
Jy
Jy
Jy
Jy
Jy
Jy
Jy
Jy
Jy
Jy
Jy
Jy
Jy
Jy
Jy
Jy
Jy
Jy
Jy
Jy
Jy
Jy
Jy
Jy
Jy
Jy
HT
HT
fn
fn
fn
fn
fn
fX
fn
fn
fn
fX
fn
fn
fn
fX
fn
fn
Jy
Jy
Jy
Jy
"}
(48,1,1) = {"
Jy
Jy
Jy
Jy
Jy
Jy
Jy
Jy
Jy
Jy
Jy
Jy
Jy
Jy
Jy
Jy
Jy
Jy
Jy
Jy
Jy
Jy
Jy
Jy
Jy
Jy
Jy
Jy
Jy
Jy
Jy
Jy
Jy
Jy
Jy
Jy
Jy
Jy
Jy
Jy
Jy
Jy
Jy
Jy
Jy
Jy
Jy
Jy
Jy
HT
HT
fn
fn
fn
fn
fn
fn
fn
fn
fn
fn
fn
fn
fn
fn
fn
Jy
Jy
Jy
Jy
"}
(49,1,1) = {"
Jy
Jy
Jy
Jy
Jy
Jy
Jy
Jy
Jy
Jy
Jy
Jy
Jy
Jy
Jy
Jy
Jy
Jy
Jy
Jy
Jy
Jy
Jy
Jy
Jy
Jy
Jy
Jy
Jy
Jy
Jy
Jy
Jy
Jy
Jy
Jy
Jy
Jy
Jy
Jy
Jy
Jy
Jy
Jy
Jy
Jy
Jy
Jy
Jy
Jy
HT
HT
fn
fn
fn
fn
fn
fX
fn
fn
fn
fX
fn
fn
fn
fX
Jy
Jy
Jy
Jy
"}
(50,1,1) = {"
Jy
Jy
Jy
Jy
Jy
Jy
Jy
Jy
Jy
Jy
Jy
Jy
Jy
Jy
Jy
Jy
Jy
Jy
Jy
Jy
Jy
Jy
Jy
Jy
Jy
Jy
Jy
Jy
Jy
Jy
Jy
Jy
Jy
Jy
Jy
Jy
Jy
Jy
Jy
Jy
Jy
Jy
Jy
Jy
Jy
Jy
Jy
Jy
Jy
Jy
Jy
HT
HT
HT
HT
HT
HT
HT
HT
HT
HT
HT
HT
HT
HT
HT
Jy
Jy
Jy
Jy
"}
