//MAP CONVERTED BY dmm2tgm.py THIS HEADER COMMENT PREVENTS RECONVERSION, DO NOT REMOVE
"a" = (
/turf/open/floor/facility,
/area/city)
"d" = (
/obj/effect/decal/cleanable/dirt/dust,
/obj/structure/chair/comfy/shuttle{
	dir = 4
	},
/turf/open/floor/facility{
	color = "#b5b5b5"
	},
/area/city)
"e" = (
/obj/effect/decal/cleanable/dirt/dust,
/obj/machinery/door/airlock/grunge{
	name = "ucorp boat"
	},
/turf/open/floor/carpet/red,
/area/city)
"g" = (
/obj/structure/chair/comfy/shuttle{
	dir = 8
	},
/obj/effect/spawner/lootdrop/grille_or_trash,
/turf/open/floor/facility{
	color = "#b5b5b5"
	},
/area/city)
"h" = (
/turf/closed/indestructible/fakeglass,
/area/city)
"i" = (
/turf/closed/indestructible/opshuttle{
	color = "#6ced2f";
	name = "shipping container"
	},
/area/city)
"l" = (
/obj/effect/decal/cleanable/dirt/dust,
/turf/open/floor/carpet/green,
/area/city)
"m" = (
/turf/open/space/basic,
/area/space)
"n" = (
/obj/effect/decal/cleanable/dirt/dust,
/obj/machinery/door/airlock/grunge{
	name = "ucorp boat"
	},
/obj/docking_port/mobile{
	name = "ucorp shuttle";
	id = "boat3_elevator";
	port_direction = 2;
	dwidth = 4;
	height = 7;
	width = 9
	},
/turf/open/floor/carpet/green,
/area/city)
"p" = (
/obj/structure/chair/comfy/shuttle{
	dir = 4
	},
/turf/open/floor/facility{
	color = "#b5b5b5"
	},
/area/city)
"q" = (
/obj/structure/chair/comfy/shuttle{
	dir = 8
	},
/turf/open/floor/facility{
	color = "#b5b5b5"
	},
/area/city)
"s" = (
/obj/effect/decal/cleanable/dirt/dust,
/obj/effect/decal/cleanable/dirt/dust,
/obj/effect/spawner/lootdrop/grille_or_trash,
/turf/open/floor/facility,
/area/city)
"w" = (
/obj/structure/chair/comfy/shuttle{
	dir = 4
	},
/obj/effect/spawner/lootdrop/grille_or_trash,
/turf/open/floor/facility{
	color = "#8f8f8f"
	},
/area/city)
"y" = (
/obj/effect/decal/cleanable/dirt/dust,
/turf/open/floor/carpet/red,
/area/city)
"z" = (
/obj/effect/decal/cleanable/dirt/dust,
/obj/structure/chair/comfy/shuttle{
	dir = 8
	},
/turf/open/floor/facility{
	color = "#8f8f8f"
	},
/area/city)
"A" = (
/turf/open/floor/facility{
	color = "#8f8f8f"
	},
/area/city)
"G" = (
/obj/structure/chair/comfy/shuttle{
	dir = 8
	},
/turf/open/floor/facility{
	color = "#8f8f8f"
	},
/area/city)
"I" = (
/turf/open/floor/carpet/green,
/area/city)
"J" = (
/obj/structure/chair/comfy/shuttle{
	dir = 4
	},
/turf/open/floor/facility{
	color = "#8f8f8f"
	},
/area/city)
"O" = (
/turf/open/floor/carpet/red,
/area/city)
"Q" = (
/obj/machinery/door/airlock/grunge{
	name = "ucorp boat"
	},
/turf/open/floor/carpet/red,
/area/city)
"S" = (
/obj/structure/chair/comfy/shuttle{
	dir = 8
	},
/obj/effect/spawner/lootdrop/grille_or_trash,
/turf/open/floor/facility,
/area/city)
"T" = (
/turf/closed/indestructible/opshuttle{
	color = "#ed2f5f";
	name = "shipping container"
	},
/area/city)
"U" = (
/turf/open/floor/facility{
	color = "#b5b5b5"
	},
/area/city)
"X" = (
/obj/effect/decal/cleanable/dirt/dust,
/turf/open/floor/facility,
/area/city)
"Z" = (
/obj/machinery/door/airlock/grunge{
	name = "ucorp boat"
	},
/turf/open/floor/carpet/green,
/area/city)

(1,1,1) = {"
m
i
i
h
i
i
m
"}
(2,1,1) = {"
T
T
p
y
p
i
i
"}
(3,1,1) = {"
h
J
w
O
p
d
h
"}
(4,1,1) = {"
e
U
l
O
s
U
Z
"}
(5,1,1) = {"
Q
O
O
A
I
I
n
"}
(6,1,1) = {"
e
a
X
I
y
a
Z
"}
(7,1,1) = {"
h
g
q
l
z
q
h
"}
(8,1,1) = {"
T
T
G
l
S
i
i
"}
(9,1,1) = {"
m
T
T
h
T
T
m
"}
